type octile
height 9
width 13
map
@@@@@@@@@@@@@
@.....@.....@
@.....@.....@
@.....@.....@
@...........@
@.....@.....@
@.....@.....@
@.....@.....@
@@@@@@@@@@@@@
